##### 
#   ##
#  $ #
# $ @#
###. #
  #.##
  #. #
###. #
#  $ #
# $  #
##  ##
 #### 
