###### ####
#    ###  #
# $$  ##  #
#  # $    #
## ## $#  #
 # #...  ##
 #  ...#$##
 # #...#  #
## # ###@ #
#  $ $  $ #
# #$####  #
#   #  ####
#####      
