####    
#  #####
#  #   #
# .  # #
##$#  .#
 # #$# #
##.  . #
#  ##  #
#  #  *#
# $  $ #
# $#* @#
#  #.###
######  
