######## 
#      # 
# @ $# # 
## #   # 
# $#.# # 
#  .*.$# 
## #.# # 
 # #.  ##
## $.#  #
#  # $  #
# $   ###
#  ####  
####     
