   ######  
   # ...#  
####....#  
#  ###$ ###
# $ $  $$ #
#@ $ $    #
#  ####   #
####  #####
