###########        
#......   #########
#......   #  ##   #
#..### $    $     #
#... $ $ #  ###   #
#...#$#####    #  #
###    #   #$  #$ #
  #  $$ $ $  $##  #
  #  $   #$#$ ##$ #
  ### ## #    ##  #
   #  $ $ ## ######
   #    $  $  #    
   ##   # #   #    
    #####@#####    
        ###        
