  ######           
  #   @####        
##### $   #        
#   ##    ####     
# $ #  ##    #     
# $ #  ##### #     
## $  $    # #     
## $ $ ### # #     
## #  $  # # #     
## # #$#   # #     
## ###   # # ######
#  $  #### # #....#
#    $    $   ..#.#
####$  $# $   ....#
#       #  ## ....#
###################
