#######
#  @  #
##$ $ #
#  $$##
#....# 
###### 
