          #######
          #  ...#
      #####  ...#
      #      . .#
      #  ##  ...#
      ## ##  ...#
     ### ########
     # $$$ ##    
 #####  $ $ #####
##   #$ $   #   #
#@ $  $    $  $ #
###### $$ $ #####
     #      #    
     ########    
