########
#..    #
#..$ $@#
#$#$$$##
#..$ $ #
#..    #
########
