########  
#     .#  
# #$#..## 
#   $...# 
## ##.$.# 
 # ##  ## 
 #$##  #  
##   #$#  
#  #   #  
#   $ ####
# $ $   @#
#  ###   #
#### #####
