   ###     
   #.######
 ###.$ #  #
 #...  #$ #
 #.## $   #
##.$ $## ##
#.$ # ## # 
#.#$     # 
#.$  #$ $# 
#. $## @ # 
#.$    $ # 
#. ####### 
####       
