             ######
 #############....#
##   ##     ##....#
#  $$##  $ @##....#
#      $$ $#  ....#
#  $ ## $$ # # ...#
#  $ ## $  #  ....#
## ##### ### ##.###
##   $  $ ##   .  #
# $###  # ##### ###
#   $   #       #  
#  $ #$ $ $###  #  
# $$$# $   # ####  
#    #  $$ #       
######   ###       
     #####         
