   ##### 
####   ##
# $ $   #
#@#.*.# #
# #.*.# #
#   $ $ #
##   ####
 #####   
