#########
#   .$ @#
# $ * $ #
#*...*.*#
# $$*   #
#   . $ #
#########
