   ########
####    . #
#  $ $ $. #
#  .####.##
# $.$ $ @# 
#  .    ## 
#########  
