####   
#  ####
#  $  #
# #.# #
# # # #
#.$.$.#
# # # #
# #.# #
#  $$ #
## @  #
 #  ###
 ####  
