    ##########     
#####        ####  
#     #   $  #@ #  
# #######$####  ###
# #    ## #  #$ ..#
# # $  $  #  #  #.#
# # $  #     #$ ..#
# #  ### ##     #.#
# ###  #  #  #$ ..#
# #    # $####  #.#
# #$   $  $  #* ..#
#    $ # $ $ #  #.#
#### $###    #* ..#
   #    $$ ###....#
   #      ## ######
   ########        
