   #####
####  .#
#   $ *#
# $$ $.#
##@##..#
 #######