    ####  
  ###  ## 
 ##     ##
 #   # ..#
## $#*#$.#
#  $ # $.#
#  $ @ $.#
#  $ # $.#
##$$#*#$.#
 #.  # ..#
 ##.    ##
  ###  ## 
    ####  
