 ####### 
##  *  ##
# . . . #
# $ *   #
#*$$*$$*#
#   * $ #
# . .@. #
##  *  ##
 ####### 
