 ##########
##        #
#@ $$$ $  #
## $  $ $ #
 ## #### ##
  #    $ ##
### ##$ $ #
#    #    #
#    ######
#    ##    
#.....#    
#.....#    
#######    
