   ######
####.  @#
#  $$$  #
#.##.##.#
#   $   #
#  $.# ##
####   # 
   ##### 
