#########
#       #
# # ### #
# $$  # #
#@$   # #
## ## # #
#   $ $ #
# $## # #
#   #$# #
#...#   #
#.#.#$###
#...  #  
#######  
