######## 
#  #.. ##
# $. $* #
#  $@$  #
# *$ .$ #
## ..#  #
 ########
