##########
#..$ $ *.#
#.* $ $..#
##.$ $ *##
 #* $ $.# 
 #.$ $ .# 
 #. $ $.# 
 #.$@$ *# 
##* $ $.##
#..$ $ *.#
#.* $ $..#
##########
