#########
#   *   #
# $.$. @#
# .$.$. #
# $.$.$ #
#   *   #
#########
