#########
#.  $. @#
# .$.$  #
##$.$ $##
# .$.$  #
#.  $.  #
#########
