   #######
 ###     #
##   # # #
#  #.$$$ #
# #.*# ###
#  ..# #  
###..$ ## 
  #.# $ # 
 ## # #@# 
 # $  $ # 
 #    ### 
 ######   
