#####    
#   #    
#@$$# ###
# $ # #.#
### ###.#
 ##    .#
 #   #  #
 #   ####
 #####   